11111111111111
10000111000011
111101110111E1
11110000011101
11110111011101
1P0001110000C1
11111111111111