111111111111111111111111111
100001110000E11111111111111
111101110111100000000000111
111100000111000001111000111
111101110111011111111110111
1P0001110000C01111110000001
111111111111111111111111111