1111111
1P10001
100C001
10000E1
1111111