11111111
10001E01
1C001011
10000001
11111111