111111111
2222 2222
333   333
44     44
5       5
5       5
44     44
333   333
2222 2222
111111111