1111111111111
1001000 00 C1
10000 111   1
1P0011E000  1
1111111111111