1111111111111
10010000100C1
10000110100C1
1P0011E0100C1
1111111111111