1111111111
1000000P11
1111110111
1EEP000001
1PCCC00001
1111111111